0000000000
1111011111
0001010000
0111011110
0000000000
0111011111
0051011111
1111000000
0000011111
1111011111